border_size=1
usage=map

Wo          , Wo          , Wo          , Wo          , Wo          , Wo          , Wo          , Wo          , Wo          , Wo          , Wo          , Wo          , Wo          , Wo          , Wo          , Wo          , Wo          , Wo          , Wo          , Wo          , Wo          , Wo          
Wo          , Wo          , Wo          , Wo          , Wo          , Ww          , Ww          , Ww          , Ww          , Ww          , Ww          , Ww          , Ww          , Ww          , Ww          , Ww          , Ww          , Ww          , Ww          , Ww          , Wo          , Wo          
Wo          , Wo          , Wo          , Ww          , Ch          , Ww          , Ch          , Ds          , Ds          , Ds          , Ds          , Ww          , Ds          , Ww          , Ww          , Ww          , Ww          , Ww          , Ww          , Ww          , Ww          , Wo          
Wo          , Wo          , Wo          , Ww          , Ch          , 1 Kh        , Ch          , Gg          , Gg          , Gg          , Gg          , Ds          , Gg          , Ds          , Ds          , Ds          , Ds          , Ds          , Ww          , Ww          , Ww          , Wo          
Wo          , Wo          , Wo          , Ch          , Ch          , Ch          , Gg          , Gg          , Gg          , Gg          , Gg          , Gg          , Gg          , Gg          , Gg          , Ds          , Gs          , Ds          , Ds          , Ww          , Ww          , Wo          
Wo          , Wo          , Wo          , Ww          , Ds          , Ch          , Gg          , Gg          , Gg          , Gg          , Gg          , Gg          , Gs          , Gg          , Gs          , Gs          , Gs          , Gg          , Gg          , Ds          , Ww          , Wo          
Wo          , Wo          , Ww          , Ww          , Ww          , Ds          , Ds          , Gg          , Gg          , Gg          , Gg          , Gg          , Gs          , Gs          , Gs          , Gs          , Re          , Re          , Gg          , Ds          , Ww          , Wo          
Wo          , Ww          , Ww          , Ww          , Ds          , Ds          , Gg          , Gg          , Gg          , Gs          , Gs          , Gs          , Gs          , Gs          , Re          , Re          , Re          , Re          , Ds          , Ds          , Ww          , Wo          
Wo          , Ww          , Ds          , Ds          , Gg          , Gg          , Gg          , Gg          , Gs          , Gs          , Gs          , Gs          , Gs          , Gs          , Gs          , Re          , Re          , Ds          , Ww          , Ds          , Ww          , Wo          
Wo          , Ww          , Ww          , Ds          , Gg          , Gg          , Gg          , Gg          , Gs          , Gs          , Gs          , Gs          , Gs          , Gs          , Re          , Re          , Re          , Ds          , Ds          , Ww          , Ww          , Wo          
Wo          , Ww          , Ww          , Ds          , Ds          , Ds          , Ds          , Gg          , Gs          , Gs          , Gs          , Gs          , Gs          , Gs          , Re          , Rd          , Rd          , Ds          , Ds^Edpp     , Ww          , Ww          , Wo          
Wo          , Ww          , Ww          , Ww          , Ww          , Ww          , Ds          , Gg          , Gs          , Gs          , Gs          , Gs          , Re          , Re          , Rd          , Rd          , Rd          , Ds          , Dd          , Dd^Vda      , Ww          , Wo          
Wo          , Ww          , Ww          , Ww          , Ww          , Ww          , Ds          , Gs          , Gs          , Gs          , Gd          , Gs          , Gs          , Gd          , Gd          , Rd          , Rd          , Dd          , Dd^Vda      , Dd          , Ww          , Wo          
Wo          , Ww          , Ww          , Ww          , Ds          , Ds          , Gs          , Gs          , Gd          , Gd          , Gd          , Gs          , Gs          , Gd          , Ds          , Ds          , Dd          , Dd          , Ww          , Ww          , Ww          , Wo          
Wo          , Ww          , Ds          , Ds          , Ds          , Gd          , Gs          , Gs          , Gd          , Gd          , Rd          , Gd          , Gd          , Gd          , Dd          , Dd^Dr       , Dd          , Ww          , Ww          , Ww          , Ww          , Wo          
Wo          , Ww          , Ds          , Ds          , Ds          , Re          , Re          , Gd          , Gd          , Gd          , Rd          , Rd          , Ds          , Dd          , Dd          , Dd^Vda      , Cd          , Ww          , Cd          , Ww          , Ww          , Wo          
Wo          , Ww          , Ds          , Ds          , Ds          , Ds          , Ds          , Re          , Ds          , Rd          , Rd          , Rd          , Dd          , Dd          , Dd          , Cd          , Cd          , Ww          , 2 Kd        , Cd          , Ww          , Wo          
Wo          , Ww          , Ww          , Ds          , Ww          , Ww          , Ww          , Ds          , Rd          , Rd          , Dd          , Dd          , Dd          , Dd^Do       , Dd^Do       , Dd          , Cd          , Cd          , Cd          , Cd          , Ww          , Wo          
Wo          , Ww          , Ww          , Ww          , Ww          , Ww          , Ds          , Ds          , Ds          , Ds          , Dd          , Dd          , Dd^Vda      , Dd^Do       , Dd          , Dd          , Cd          , 3 Kd        , Ww          , Ww          , Ww          , Wo          
Wo          , Ww          , Ww          , Ww          , Ds          , Ds          , Ds          , Ds          , Ds          , Ds          , Dd          , Dd          , Dd          , Dd          , Ww          , Dd          , Ww          , Ww          , Ww          , Ww          , Wo          , Wo          
Wo          , Ww          , Ww          , Ww          , Ww          , Ww          , Ww          , Ds          , Ww          , Ww          , Ww          , Ww          , Ww          , Ww          , Ww          , Ww          , Ww          , Ww          , Ww          , Ww          , Wo          , Wo          
Wo          , Wo          , Wo          , Wo          , Wo          , Wo          , Wo          , Wo          , Wo          , Wo          , Wo          , Wo          , Wo          , Wo          , Wo          , Wo          , Wo          , Wo          , Wo          , Wo          , Wo          , Wo          
