border_size=1
usage=map

Gg, Gg, Gg, Gg, Gg, Mm^Xm, Mm^Xm, Mm^Xm, Mm^Xm, Mm^Xm, Mm^Xm, Mm^Xm, Mm^Xm, Mm^Xm, Mm^Xm, Mm^Xm, Mm^Xm, Mm^Xm, Xue, Xue, Qlf, Xue, Xue, Xue, Xue, Xue, Xue, Xue, Xue, Xue, Xue, Mm^Xm, Mm^Xm, Mm, Gg, Gg, Gg, Gg, Gg, Gg, Gg, Gg, Gg, Gg, Gg, Gg
Gg, Gg, Gg, Gg, Gg, Gg, Gg, Gs^Fds, Gs^Fds, Mm^Xm, Gs^Fds, Mm^Xm, Mm^Xm, Mm^Xm, Mm^Xm, Mm^Xm, Mm^Xm, Mm^Xm, Xue, Xue, Qlf, Ce, Ce, Xue, Uu, Uu^Uf, Uu^Uf, Xue, Uu, Uu^Uf, Mm^Xm, Mm^Xm, Mm^Xm, Mm, Hh, Gg, Gs^Fds, Gg, Gg, Gg, Gs^Fds, Gg, Gs^Fds, Gg, Gg, Gg
Gg, Gg, Gg, Gg, Gs^Fds, Gg, Gs^Fds, Gs^Fds, Gg, Gs^Fds, Gs^Fds, Hh, Hh, Mm^Xm, Mm^Xm, Mm^Xm, Xue, Xue, Xue, Qlf, Uh, Uu, Uu^Uf, Xue, Uh, Ur, Uu^Uf, Uu, Uu, Uu, Ur, Mm^Xm, Mm^Xm, Mm, Hh, Gg, Gg, Gs^Fds, Gg, Gg, Gs^Fds, Gg, Gs^Vh, Gs^Fds, Gg, Gg
Gg, Gg, Gs^Fds, Gs^Fds, Gg, Gs^Fds, Gs^Fds, Gg, Gg, Gs^Fds, Gg, Hh, Mm^Xm, Mm^Xm, Xue, Xue, Xue, Xue, Xue, Uu, Ur, Ur, Ur, Uh, Uu, Uu^Uf, Xue, Xue, Xue, Uu, Ur, Ur, Gg, Qxu, Qxu, Gg, Qxu, Qxu, Qxu, Gs^Fds, Gg, Gg, Gg, Gs^Fds, Gs^Fds, Gg
Gg, Gg, Gs^Fds, Gg, Gg^Ve, Gg, Gg, Gg, Gg, Gg, Gg, Hh, Mm^Xm, Xue, Xue, Uu, Uu, Xue, Uu, Uh, Xue, Xue, Xue, Uu^Uf, Xue, Xue, Mm^Xm, Xue, Mm^Xm, Xue, Xue, Gg, Gg, Qxu, Qxu, Qxu, Gs^Fds, Gs^Fds, Gg, Gs^Fds, Gg, Gg, Gg, Gs^Fds, Gg, Gs^Fds
Gg, Gg, 2 Kv, Gs^Fds, Gs^Fds, Gs^Fds, Gs^Fds, Gg, Gs^Fds, Gg, Gg, Hh, Mm^Xm, Mm^Xm, Xue, Uu, Ur, Uu, Uu^Uf, Uu^Uf, Xue, Xue, Mm^Xm, Xue, Mm^Xm, Mm^Xm, Mm^Xm, Mm^Xm, Mm^Xm, Mm^Xm, Mm^Xm, Gg, Qxu, Qxu, Gg, Gs^Fds, Gg, Gg, Gg, Gg, Gg, Gg, Gg, Gg, Gg, Gg
Gg, Gg, Cv, Cv, Gg, Gg, Gg, Gg, Gg, Gg, Gs^Fds, Gg, Gg, Mm, Gg, Ur, Mm, Xue, Xue, Xue, Mm^Xm, Mm^Xm, Mm, Mm^Xm, Mm^Xm, Mm^Xm, Mm, Mm^Xm, Mm, Mm^Xm, Mm^Xm, Gg, Gg, Gg, Gg, Gs^Fds, Gg, Gs^Fds, Gg, Gs^Fds, Gs^Fds, Gs^Fds, Gg, Gg, Gs^Fds, Gs^Fds
Gg, Gg, Cv, Cv, Gg, Gg, Gg, Gg, Gs^Fds, Gs^Fds, Gs^Fds, Gg, Gg, Gg, Gg, Gg, Gg, Mm, Mm, Mm^Xm, Mm, Mm, Mm, Mm, Mm, Mm, Gg, Hh^Vhh, Hh, Mm, Mm, Gg, Ss, Gg, Gg, Gs^Fds, Gs^Fds, Gg, Gg, Gg, Gg, Gg, Gs^Fds, Gg, Gs^Fds, Gg
Gg, Gg, Cv, Gg, Gg, Gg, Gg, Gs^Fds, Gg, Gg, Gs^Fds, Gg, Gg, Gg, Gg, Gg, Gg, Gs^Fds, Gs^Fds, Mm, Gs^Fds, Hh^Vhh, Gg, Gg, Gg, Gg, Gg, Gg, Gs^Fds, Hh, Gg, Gg, Ss, Ss, Ss, Gs^Fds, Gs^Fds, Gg, Gs^Fds, Gg, Ss, Gg, Gs^Fds, Gs^Fds, Gg, Gg
Gg, Gg, Gg, Gs^Fds, Gg, Gg, Gg, Gs^Fds, Gs^Fds, Gg, Gg^Ve, Gs^Fds, Gg, Gs^Fds, Gg, Gg, Gs^Fds, Gs^Fds, Gg, Gg, Gs^Fds, Gg, Gg, Gg, Gg, Gs^Fds, Gs^Fds, Gs^Fds, Gg, Gs^Fds, Ss, Ss, Ss, Ss, Ss, Wwf, Gg, Wwf, Ss, Gg, Gg, Gg, Gg, Gs^Fds, Gs^Fds, Gg
Gg, Gg, Gs^Fds, Gs^Fds, Gg^Ve, Gg, Gg, Gg, Gg, Gs^Fds, Gs^Fds, Gg, Qxu, Gg, Gg, Gg, Gg, Gg, Gg, Gg, Gs^Fds, Gg, Gg, Gg, Gs^Fds, Gg, Gs^Fds, Gg, Gg, Gg, Ss, Gg, Wwf, Wwf, Ss, Sm, Wwf, Gs^Vht, Ss, Gg, Gg, Ss, Gg, Gg, Gg, Gs^Fds
Gg, Gg, Gg, Gs^Fds, Gg, Gg, Gg, Gg, Gg, Gg, Gg, Qxu, Qxu, Gs^Fds, Gg, Gg, Gs^Fds, Gs^Fds, Gg, Gg, Gs^Fds, Gg, Gs^Fds, Gs^Fds, Gs^Fds, Gs^Fds, Gs^Fds, Gg, Gg, Ss, Ss, Gs^Fds, Ss, Ss, Wwf, Gs^Fds, Wwf, Ss, Ss, Ss, Ss, Ss, Gs^Fds, Gg, Gg, Gg
Gg, Gg, Gg, Gg, Gg, Gg, Gg, Gg, Gg, Gg, Gg, Qxu, Qxu, Qxu, Gg, Gs^Fds, Gg, Gs^Fds, Gs^Fds, Gg, Gg, Gs^Fds, Gs^Fds, Gs^Fds, Gs^Fds, Gg, Gs^Fds, Gg, Ss, Ss, Gg, Ss, Ss, Sm, Chs, Khs, Gg, Gg, Ss, Wwf, Gs^Fds, Gs^Fds, Gg, Gg, Gg, Gg
Gg, Gg, Gg, Gg, Gg, Gg, Gs^Fds, Gg, Gg, Gg, Gg, Gs^Fds, Qxu, Qxu, Qxu, Gg, Gs^Fds, Gg, Ss, Gg, Ss, Gs^Fds, Gg, Gs^Fds, Ss, Ss, Ss, Ss, Gs^Fds, Gs^Vht, Gs^Fds, Ss, Wwf, Sm, Ss, Wwf, Ss, Ss, Sm, Sm, Gs^Fds, Gg, Gg, Gg, Gg, Gg
Gg, Gg, Gg, Gg, Gg, Gg, Gg, Gs^Fds, Gs^Fds, Gg, Gg, Gg, Gg, Gg, Qxu, Gg, Gg, Gs^Fds, Ss, Gs^Fds, Gg, Ss, Ss, Ss, Ss, Gg, Gg, Gg, Gs^Fds, Gs^Fds, Gs^Fds, Gs^Fds, Ss, Gg, Wwf, Ss, Ss, Gg, Ss, Ss, Gs^Fds, Gg, Gg, Gg, Gg, Gg
Gg, Gg, Gg, Gg, Gg, Gg, Gg, Gs^Fds, Gs^Fds, Gs^Fds, Gs^Fds, Gg, Gg, Gg, Gs^Fds, Gs^Fds, Gg, Gs^Fds, Ss, Ss, Gg, Gs^Fds, Gg, Gg, Gs^Fds, Gs^Fds, Gg, Gg, Gs^Fds, Gs^Fds, Gs^Fds, Gg, Gg, Ss, Gg, Ss, Gg, Gg, Gg, Gg, Gg, Gs^Fds, Gs^Fds, Gg, Gg, Gg
Wwt, Gs^Fds, Gg, Gg, Gg, Gg, Gg, Gs^Fds, Gg, Gs^Fds, Gg, Gg, Gg, Gg, Gs^Fds, Gg, Gg, Ss, Ss, Gs^Fds, Gs^Fds, Gg, Gs^Fds, Gs^Fds, Gg, Gg, Gs^Fds, Gs^Fds, Ch, Gg, Gs^Fds, Gs^Fds, Gs^Fds, Gg, Qxu, Qxu, Gs^Fds, Gs^Fds, Gs^Fds, Gs^Fds, Gs^Fds, Gg, Gs^Fds, Gs^Fds, Gg, Gg
Wo, Wwt, Wwt, Gg, Wwt, Gs^Fds, Gs^Fds, Gg, Gg, Gg^Ve, Gg, Gg, Gg, Gg, Gs^Fds, Ss, Ss, Gg, Gg, Gs^Fds, Gs^Fds, Gs^Fds, Gg, Gs^Fds, Ce, Ce, Ce, Gs^Fds, Gs^Fds, Gg, Gg, Gg, Gg, Qxu, Qxu, Gs^Fds, Gg, Gg, Gg, Gg, Gg, Gs^Fds, Gg, Gg, Gg, Gs^Fds
Wo, Ww^Vm, Wwt, Wwt, Wwt, Wwt, Wwt, Gs^Fds, Wwt, Gg, Wwt, Gg, Wwt, Ss, Gg, Gg, Gg, Gg, Gg, Gs^Fds, Gg, Gg, Gg, Gs^Fds, Ce, Ce, Ce, Gs^Fds, Gg^Ve, Gs^Fds, Gg, Gg, Gs^Vh, Qxu, Gs^Fds, Gg, Gg, Gg, Gg, Gg, Gg, Gg, Gg, Gg, Gg, Gg
Wo, Wo, Wwt, Wwt, Wwt, Wwt, Wwt, Wwt, Wwt, Wwt, Wwt, Wwt, Wwt, Wwt, Gs^Vh, Gg, Hh^Fds, Gg, Hh^Fds, Gg, Gg, Gg, Mm, Gs^Fds, Mm, 1 Ke, Mm, Gs^Fds, Gg, Gs^Fds, Gs^Fds, Gg, Gg, Gg, Gs^Fds, Gg, Gs^Fds, Gg, Gs^Fds, Gg, Gg, Gs^Fds, Gs^Fds, Gg, Gs^Fds, Gg
Wwt, Wo, Wwt, Wwt, Wwt, Wwt, Wwt, Wo, Wo, Wo, Wo, Wo, Wo, Wwt, Wwt, Gg, Hh^Fds, Hh^Fds, Hh^Fds, Hh^Fds, Mm, Mm, Mm, Mm, Mm, Mm, Mm, Gg, Gg, Gs^Fds, Gs^Fds, Gg, Gs^Vh, Ss, Gs^Fds, Gs^Fds, Gs^Fds, Gs^Fds, Ch, Gs^Fds, Gs^Fds, Gg, Gg, Gg, Gs^Fds, Gg
Gg, Wwt, Gg, Gg, Gg, Wwt, Wwt, Wwt, Wwt, Wo, Wo, Wo, Wwt, Wwt, Wwt, Hh^Fds, Hh^Fds, Hh^Fds, Mm, Mm, Mm, Mm, Hh, Mm, Gg, Mm, Mm, Gs^Fds, Gg, Gg, Gs^Fds, Gs^Fds, Qxu, Ss, Gs^Fds, Gg, Gg, Ch, Gg, Gg, Gg, Gs^Fds, Gg, Gg, Gs^Fds, Gg
Gg, Gg, Gs^Fds, Gg, Gg, Gg, Gs^Vh, Wwt, Hh, Wwt, Wwt, Wwt, Wwt, Wwt, Wwt, Wwt, Mm, Mm, Mm, Mm, Mm, Hh, Hh, Gg, Gg, Gs^Fds, Gs^Fds, Gg, Gs^Fds, Qxu, Qxu, Qxu, Qxu, Gs^Fds, Gg, Gg, Gg, Gg, Gg, Gg, Gg, Gs^Fds, Gg, Gs^Fds, Gg, Gg
Gg, Gs^Fds, Gg, Gg, Gg, Gg, Mm, Mm, Mm, Mm, Wwt, Wwt, Wo, Wo, Wo, Wwt, Wwt, Mm, Mm, Mm, Mm, Mm, Mm, Gg, Hh^Fds, Gs^Fds, Gs^Fds, Gg, Qxu, Qxu, Qxu, Qxu, Gg, Gg, Gs^Fds, Gs^Fds, Gg, Gs^Fds, Gg, Gs^Fds, Gs^Fds, Gs^Fds, Gg, Gs^Fds, Gg, Gg
Gg, Gg, Gg, Gg, Gs^Fds, Gg, Hh, Mm, Mm^Xm, Mm, Wwt, Wo, Wo, Wo, Wo, Wo, Wwt, Mm, Mm, Mm^Xm, Mm^Xm, Mm, Mm, Hh^Fds, Hh^Fds, Gg, Gg, Gg, Gg, Qxu, Gs^Fds, Qxu, Gg, Gs^Fds, Gg, Gg, Gg, Gg, Gg, Gg, Gg, Gg, Ch, Ch, Gg, Gg
Gg, Gg, Gs^Fds, Gs^Fds, Gg, Gs^Fds, Gg, Mm^Xm, Mm^Xm, Hh, Gg, Wwt, Wo, Wo, Wo, Wo, Wo, Wwt, Mm^Xm, Mm^Xm, Mm^Xm, Mm, Mm, Hh, Hh^Fds, Hh^Fds, Gg, Gg, Gg, Gg, Gg, Gg, Gs^Fds, Gg, Gg, Gg, Gg, Gg, Gg, Gg, Gs^Vh, Ch, 3 Kh, Ch, Ch, Gg
Gs^Fds, Gg, Gg, Gg, Gs^Fds, Gs^Fds, Gg, Gg, Gg, Gs^Fds, Gg, Wwt, Wwt, Wwt, Wo, Wo, Wo, Wwt, Wwt, Mm^Xm, Mm^Xm, Mm^Xm, Wwt, Mm, Wwt, Hh^Fds, Wwt, Gg, Wwt, Gg, Gg, Gg, Gg, Gg, Gg, Gg, Mm^Xm, Mm^Xm, Mm^Xm, Mm^Xm, Mm^Xm, Wwt, Wwt, Wwt, Wwt, Wwt
Gg, Gs^Fds, Gs^Fds, Gs^Fds, Gg, Gs^Fds, Gg, Gg, Gg, Gg, Gg, Gg, Wwt, Wwt, Ww^Vm, Wo, Wo, Wo, Wo, Wwt, Wwt, Wwt, Wo, Wwt, Wo, Wwt, Wwt, Wwt, Wo, Wwt, Wwt, Wwt, Wwt, Wwt, Wwt, Mm^Xm, Wwt, Mm^Xm, Wwt, Mm^Xm, Wwt, Wwt, Wwt, Wwt, Wwt, Gg
Gg, Gg, Gg, Gg, Gg, Gs^Fds, Gs^Fds, Gs^Fds, Gg, Gg, Gg, Gg, Gg, Wwt, Wwt, Wwt, Wwt, Wo, Wo, Wo, Wwt, Wo, Wo, Wo, Wo, Wo, Wo, Wwt, Wo, Wo, Wwt, Wwt, Wwt, Wwt, Wwt, Wwt, Wwt, Wwt, Wwt, Wwt, Wwt, Wwt, Wwt, Wwt, Wwt, Wwt
Gg, Gg, Gg, Gg, Gs^Vh, Gg, Gg, Gg, Gg, Gg, Gg, Gg, Gg, Gg, Gg, Gs^Fds, Hh, Wwt, Wwt, Wo, Wwt, Wo, Wwt, Wo, Wo, Wo, Wo, Wwt, Wwt, Wwt, Wwt, Wwt, Wwt, Wwt, Wwt, Wwt, Wwt, Wwt, Wwt, Wwt, Gg, Wwt, Gg, Gg, Gs^Fds, Gg
Mm, Mm, Hh, Gs^Vh, Mm, Gg, Mm, Mm, Mm, Hh^Fds, Hh^Fds, Gg, Gg, Gg, Hh, Hh, Hh, Hh, Gg, Wwt, Gg, Wwt, Wwt, Wwt, Wwt, Wo, Wwt, Wwt, Gg, Gg, Gg, Gg, Gg, Gg, Gs^Fds, Gs^Fds, Gs^Fds, Gs^Fds, Gs^Fds, Gg, Gg, Gg, Gg, Gg, Mm, Gg
Mm, Mm, Mm, Mm, Mm, Mm, Mm^Xm, Mm, Mm^Xm, Mm, Mm, Mm, Mm, Hh, Hh, Hh, Mm, Hh, Hh, Gg, Gg, Gg, Gg, Gs^Vh, Gg, Wwt, Gg, Gg, Gg, Gg, Co, Hh, Hh, Hh, Hh, Gs^Fds, Gs^Fds, Gs^Fds, Mm, Hh^Fds, Mm, Hh^Vhh, Mm, Mm, Mm^Xm, Mm
Mm, Mm, Mm, Mm, Mm, Hh^Fds, Mm^Xm, Mm^Xm, Mm^Xm, Mm^Xm, Mm^Xm, Gg, Mm^Xm, Mm, Mm, Mm, Mm, Mm, Mm, Hh, Mm, Gg, Mm, Gg, Gg, Gg, Gg, Gg, Gg, Gg, Co, Co, Hh, Mm, Hh^Fds, Hh, Hh^Vhh, Mm, Mm, Mm, Mm, Mm, Mm, Mm, Mm^Xm, Mm^Xm
Mm, Mm, Mm, Mm, Mm, Mm^Xm, Mm^Xm, Mm^Xm, Mm^Xm, Mm^Xm, Mm^Xm, Mm^Xm, Mm^Xm, Mm, Mm, Mm, Mm, Mm, Mm, Mm, Mm, Mm, Hh, Hh, Gs^Fds, Gg, Gg, Gg, Gg, Gg, Gg, Co, Ko, Hh^Fds, Hh^Fds, Hh^Fds, Mm, Mm, Mm, Mm, Mm^Xm, Mm, Mm^Xm, Mm^Xm, Mm^Xm, Mm^Xm
Mm, Mm, Mm, Mm, Mm, Mm, Mm, Mm^Xm, Mm^Xm, Mm^Xm, Mm^Xm, Mm^Xm, Mm^Xm, Mm^Xm, Mm^Xm, Mm^Xm, Mm^Xm, Mm^Xm, Mm^Xm, Mm^Xm, Mm^Xm, Mm^Xm, Mm^Xm, Mm, Gs^Fds, Gs^Fds, Gg, Gg, Gg, Gg, Gg, Gg, Gg, Hh^Fds, Hh^Fds, Hh^Fds, Mm, Mm, Mm, Mm^Xm, Mm^Xm, Mm^Xm, Mm^Xm, Mm^Xm, Mm^Xm, Mm^Xm
